  ===              !
===X==             !
=OBB =             !
=    =             !
=== O=             !
  ====             !