======              !
===X==              !
=OBB =              !
=    =              !
=== O=              !
======              !