    =====           !
    =   =           !
    =B  =           !
  ===  B==          !
  =  B B =          !
=== = == =   ====== !
=   = == =====  OO= !
= B  B          OO= !
=====     =X==  OO= !
    =     ========= !
    =======         !

