 =======            !
 =     ===          !
==B===   =          !
= X B  B =          !
= OO= B ==          !
==OO=   =           !
 ========           !

