=====               !
=O  =               !
=O B=               !
==X ==              !
=  B =              !
==   =              !
 =====              !