  ===               !
  =O=               !
  = ====            !
===B BO=            !
=O BX===            !
====B=              !
   =O=              !
   ===              !