 =====              !
 =  O=              !
 =B  =              !
 =  O=              !
 =  ==              !
=OBB=               !
=  X=               !
=====               !