=====               !
=   =               !
=   = ===           !
= B = =O=           !
= B ===O=           !
===    O=           !
 == X   =           !
 = B =  =           !
 =   ====           !
 =====              !