  ======            !
  = OO =            !
  =  B =            !
  == ===            !
  == ==             !
==== ==             !
=   X==             !
= = B =             !
=   = =             !
===   =             !
=======             !