   ===              !
  == = ====         !
 ==  ===  =         !
== B      =         !
=   XB =  =         !
=== B===  =         !
  =  =OO  =         !
 == ==O=  =         !
 =       ==         !
 =      ==          !
 ========           !