  ===               !
===X==              !
=OBB =              !
=    =              !
=== O=              !
  ====              !