============        !
=OO  =     ===      !
=OO  = B  B  =      !
=OO  =B====  =      !
=OO    X ==  =      !
=OO  = =  B ==      !
====== ==B B =      !
  = B  B B B =      !
  =    =     =      !
  ============      !