 ======             !
 = OO==             !
==BOO =             !
=  XB =             !
=  BB =             !
== OB =             !
 ======             !