 =====              !
 =   ====           !
 =   =  =           !
 ==    O=           !
=== ===O=           !
= B = =O=           !
= BB= ===           !
=X  =               !
=====               !