  ======            !
  = OO =            !
  =  B =            !
  == ===            !
   = =              !
==== =              !
=   X==             !
= = B =             !
=   = =             !
===   =             !
  =====             !